111111
100001
1000C1
1P0001
111111