11111111111111111111111111111111111111111111111111111111
10000000000000000000000000000000000000000000000000000001
10000000000000000000000000000000000000000000000000000001
1000000000000000C000000000000000000000000000000000000001
10000000000000000000000000000000000000000000000000000001
100000000000000000000000000000000000000E0000000000000001
10000000000000000000000000000000000000000000000000000001
10000000000000000000000000000000000000000000000000000001
10000000000000000000000000000000000000000000000000000001
10000000000000111111111111111111111110000000000000000001
10000000000000000000000001000000000000000000000000000001
10000000000000000000000001000000000000000000000000000001
10000000000000000000000001000000000000000000000000000001
10000000000000000000000001000000000000000000000000000001
10000000000000000000000000100000000000000000000000000001
10000000000000000000000000010000000000000000000000000001
10000000000000000000000000001111111100000000000000000001
10000000000000000000000000000000000000000000000000000001
10000000000000000000000000000000000000000000000000000001
10000000P00000000000000000000000000000000000000000000001
1000000000000000000000C0C0C0C0C0C0C0C0000000000000000001
10000000000000000000000C0C0C0C0C0C0C00000000000000000001
1000000000000000000000C0C0C0C0C0C0C0C0000000000000000000
10000000000000000000000C0C0C0C0C0C0C00000000000000000001
10000000000000000000000000000000000000000000000000000001
11111111111111111111111111111111111111111111111111111111