1111111111111111111111111111111111111111111111111111111111111111111111111111
1000000000000000000000000000000000000000000000000000000000000000000000000001
1000000000000000000000000000000000000000000000000000000000000000000000000001
10000000000000000000000000000000000000000000000000000000000000000C0000000001
1000000000000000000000000000000000000000000000000000000000000000000000000001
100000000111111110000000000000000000000000000000CCCCCCCCC0000000000000000001
100000000111111110000000000000000000000000000000CCCCCCCCC0000000000000000001
10000000011111111000000000000P000000000000000000CCCCCCCCC0000000000000000001
1000000001111111100000000000000000000000000000000000000000000000000000000001
1000000000000000000000000000000000000000000000000000000000000000000000000001
1000000000000111111111111111111111111111111110000000000000000000000000000001
100000000000000000000000000000000000000000001000000000000CC00000000000000001
1000000000000000000000000000000000000000000010000000000000000000000000000001
100000000000000000000000000C000000000000000010000000000000000000000000000001
10000000000000C00000000000000000000000000000100000000000C0000000000000000001
1000000000000000000000000000000000000000000010000000000000000000000000000001
1000000000000000000000000000000000000000000000000000000000000000000000000001
10000000000000000000000000000E00000000000000000000E0000000000000000000000001
1000000000000000000000000000000000000000000000000000000000000000000000000001
10000000000000000000000000000000000000000000000000E0000000000000000000000001
1000000000000000000000000000000000000000000000000000000000000000000000000001
1111111111111111111111111111111111111111111111111111111111111111111111111111