11111111111119
1000000000001
1000000000001
1000000000001
1111111111111
