111111
1000E1
1000C1
1P0001
111111