111111111
1000CPE01
111111111
111111111
1000CPE01
111111111
111111111
1000CPE01
111111111
111111111
1000CPE01
111111111
111111111
1000CPE01
111111111
111111111
1000CPE01
111111111
111111111
1000CPE01
111111111
111111111
1000CPE01
111111111
111111111
1000CPE01
111111111
111111111
1000CPE01
111111111
