111111111
1000CPE011111111

111111111
